1111111111111111111111111111
1C1C01110000000C010C110C01C1
1011001000N0C0011100000C0101
10C0000001111100001100N00101
11101C1001111100001100000001
1C0N10000000000C100C01110011
110P0110000C0000100000001001
11C000C0011111C1101100000001
1C000000001000000000C0111101
10000110000C1110N011100C1EC1
1111111111111111111111111111