1111111111111111111111111111
100001110000000C0000110000C1
1000001000N0C0011100000C0001
1000000001111100001100N00001
1000000001111100001100000001
1C000000000000000000C0111001
100P0110000C0000000000001001
10C000C001111100001100000001
1C000000000000000000C0111001
10000110000C0000N000000010E1
10000110000C0000000000001011
1111111111111111111111111111