11111111111111111111111111111
100P001110000000C0000110000C1
100000100000C0011100000C00011
10000000011111000011000000011
100C00000000C0000001100000001
1C000000001111100000C01110001
11001100000C00000000000010001
11C000C0011111000011000000001
1C000000000000001000C01110001
10010110000C00001000000010E01
10000110000C00001000000010101
11111111111111111111111111111
