111111111
1000C0001
1P0000001
100000C01
100E00001
111111111