11111111111111111111111111111
111PCE11111111111111111111111
11111111111111111111111111111